RBVRBBVRBVBRBVV
BVRBVVRBBVRRRBV
RBBVVRRRBBBVVVR
RBRBVVRRRRRBVRR
RBVVVBRVBVRRRBV
RVVRRRBVRRRRBVR
RVBRVBRVRBVRBVR
RVBBBRVRRBVRRBV
RVBBRRVBRRVBBVR
RVBVRRRBBBVRRBV