VVVVVVVVVVVVVVV
VVVVVRRRRRVVVVV
VVVVRRRRRRRVVVV
VVVRRBRRRBRRVVV
VVRRRRRRRRRRRVV
VVRRRRRRRRRRRVV
VVVRRBRRRBRRVVV
VVVVRBBBBBRVVVV
VVVVVRRRRRVVVVV
VVVVVVVVVVVVVVV