VVVVBVVVVVBVVVV
VVVVBBBBBBBVVVV
VVVVBBRRRBBVVVV
VVVVVBRRRBVVVVV
VVVBBRRRRRBBVVV
VVBBRRRRRRRBBVV
VVBBRRRRRRRBBVV
VVVBBRRRRRBBVVV
VVVVBBBBBBBVVVV
VVVVRRVVVRRVVVV